XXXXXXXXXXXXXXXXXXXXXXXXXXXXXXXXXXXXXXXXXXXXXXXXXXX
XTTTTTTTTTTTTTfTTETXXXXXXXXXXXTATTTTTTEEETTTTTTTTXX
XTTTTTTXXXXXXXXXXXXXXXXXXXXXXXTTTTTTTXXXXTTXXXTTTXX
XTTTTTTXTTTTEEETTTTXXXXXXXXXXXTTTTTTTXXXXfTXXXTTTXX
XTTTTTTXTkTTTTTTTTTXfTTkTTAXXXTTTTTTTXXXXTTXXXEETXX
XTTTTTTXTTTTTTTTTTTXTTEETTTXXXTTTTTTTXXXXTTXXXEETXX
XTTTTTTXXXXXXXXXDXXXTTEETTTXXXTTTTTTTXXXXTTXXXEETXX
XTTTTTTTTTTTTTTTETTXTTEETTTXXXTTTTTTTXXXXTTXXXEETXX
XTTTTTTTTTTTTTTTTTTXTTEETTTTTTTTTTTTTXXXXTTXXXEETTQ
XTTTTTTTTTTTXTTTTTTXTTTTTTTTTTTTTTTTTXXXXTTXXXXXXXX
XkTETTTTTTTTXTTTTTTXXXXXXXXXXXXXXXDXXXXXTTTXTfTTXXX
XTTTTTTTTTTTXTTEETTXTTTTTTTTTTTTTTTTTXhTTTTXTTTTXXX
XXXXXXTTXXXXXTTTTTTXTTTTTTTEEETTTTTTTXTTTTTTTTTTXXX
XATTTTTTTTTTXTTTTTTXXXDXXXXXXXXXXXXDXXTTTTTXTTTTXXX
XTTTTTTTTTTTXTTTTTTXTTTTTXTTTTATXTTTTXTTTTTXTTTEXXX
XTTTiTTTTTkTXTTTTTTTTTTTTXTTkTTTXTTTTXTEETTXXXXXXXX
XXXXXXXXXXXXXTTTTTTXTTTTTXTTTTTTXTTTTXTEXTTXXXXXXXX
XThTXTTTTTTTTTTTTTTXTTTTTTTTEETTXkTTTXTEXTTXTATTXXX
XTTTTTTTTTTTTTTTTTTXTTTTTXTTTTTTXTTTTXTEXThTTTkTXXX
XXXXXXXXXXXXXXXXXXXXXXXXXXXXXXXXXXXXXXXXXXXXXXXXXXX
